$progdir/aiff/ZombieAmbient.aiff
Dungeonwalls1.loaf
7 7 9 
9 9 13
AAAAAAAAAAAAAAAAAJAAAAAAAAAAAAAAEAAAAAAAEAAAAAAAEAAAAAAADDDAAAAA
AAAAAAAAAAAAAAAAJpggaa UdbBAA   b d1  1fb1   a ab a 1  |g DAAAAA
AAAAAAAAAAGAGAEAA      AAEAJA  AEA2AAA3AEAAkAA2AEAfAAfAD  DDDDDD
AAAAAAAA      b      kpJAAJp   AAAAEAAAAAAEAAAAAAEAAAAD  fDDDDDD
AAAAAAAA AGAGAEA bffAAJABJp    d Z b313131b131313b31AD b d fDDDD
AAAAAAAAZAEAAAAAAEAAAAAEAG       GAEAAAAAAEAAAAAAEAAAA      gDDD
AAAAAA    b      b     b Z       Z b      b      b ffA  b  b akD
AAAAAA AAAEAAAAAAEAAAAAEAG       GAEAAAAAAEAAAAAAEAAAA d    gDDD
AAAAf  222b2kfAAAAAAAAAABU       UBDDDDDDDDDDDDDDDDDDDD b  fDAAA
AAAAAA-AAAEAAAAAAAAAEAAAKAA d   AAD1     1DDDDDaaa  kDD   fDAAAA
AAAAAAZAAAAAAAAAAAA b   bKKp   pJADfDkDD DDAAAADDDD DDDD  DAAAAA
AAAAf  d fAAAEAAAAAkFAAA AAKA2AJADD DAAD DDDDDDDDDD DAAA AAADDDA
AAAA  b   A  b  AAA-AAAA AAAA AAADD DAD1       d  | |1kA-AADDkDA
AAAA d    A-AEA A d 2AAA AAAA AAADD DDD DDDD AAAAAD DAAD DADf1DA
AAAA   b  A AAA A   2AAEbEAAEbEAADD1   dDADD AAAAAD DAAD DADg1DA
AA Z        AAA A d 2AAA AAAA AAADDDDDD DDDD AAAAAD-DAAD DDg 1DA
AA AAA  AAAAAAA |  d2AAA AAAA ADDDDDDf   1  1AAAAD1 hDAD D  1DDA
AEbEAAffAAAAAAAAA  d2AAA AAAA2AD1    1DDD DDDDDDAD1 aDAD   1DDAA
AA AAA  AAAAAAAAAAAAAAAA AAAA AD AAA  DAD   f  1DD1  DAD DDDDAAA
AA AAAkkAAAAAAAAAAAAaAAEbEAAA AD faA  DDD AAAAA DD1   DD DAAAAAA
AA AAAAADDDDDAAAAAAAaAAA AAAA AD AAA 1    AdddA DDDD1  D DAAAAAA
AA AAAAAD222DDAAAAAA     AAAEbED1   1DDD   1111 DDDDD1   DAAAAAA
AEbEAAAAD2 f2DDAAAAAAA AAAAAA ADDDDDDDDD1   AAAfAADDDDDDDDDDDAAA
AA AAAAAD2   2DDAAAAAA AAAAAA2AD11111DDDDD-DDDDDDDh d   a11fDAAA
AAZAAAAAD A  f2DDAAEA   AEAAA AD11g11                  k111fDAAA
AA  AAAAD V   2DABb2U   U2bBA AD11111DDDDDfDDDDDDD      111fDAAA
AA  AAAAL A    DDAAEA   AEAAA ADkDDDDDAAADDDAAAAADh     a11fDAAA
AA      Z V  gDDABbgU d ZfbBA ADDDahDAAAAAAAAGAAADDDDDDDDDDDDAAA
AAAAAAAAGAA  DDAAAAAA   AAAAEb     <DAAA3333AkFAAAAAEAAAAKAAAAAA
AAAA akAA   DDAAAAAAAA AAAAAA ADDDDDDAAA33k3| b     b    bKAAAAA
AAAA AAAAZADDAAAAAAAAA AAAAAA AAAAAAAAAA3333A-FAAAAAEAAAA AAAAAA
AAAA AAAA AAAAA3222222 22223A AAAAAAgAAAAAAAAkAAAAAAAAAAA AAAAAA
AAAAZAEAAZAAAAA2aaaaaahhhhh2A AAa33AgAAAAAAAAbAAAAAAAAAAA AAAAAA
AAAA  b   AAAAA2AUAUAZAUAUA2A1AA33kAkAEAAAAAA AAAhaAAAAAA AAAAAA
AAAAA    AAAAAA2Ugdb f b gUbEbEA333|  b     | |3k1aAAAAKA  AKAAA
AAAAAA 2AAAAAAA1Ap f * f pA1A AAa33A-AEAAAAAA-AAAhaAfaapKA  pKAA
AAAAJA-AAKAAAAA2Ug b f bdgUbEbEAAAAA AAAAAAAAkAAAAAAAf dAAA  pKA
AAAJp  d pKAAAA2AUAUAUAUAUA2A AAAOAA AAAAAAAAAAAaf    f AAAA  GA
AJAA      AAAKA32b222b222b23A AAxyX| | ahahaf     f    dAAAA  3A
Jp    d      pKApEgbdE b Eb A1AAAOAA AAAA-AAAAAAaf    f AAAA dAA
A   AfafafA   AAEbdEfbdE bEAA AAAAf g fA   AAJAAAAAAAf  AAA  AAA
Af  AAAAAAA  fAAAEgb EgbfEAAA AAAAfffffAk  AJb   f   d pJA  AAAA
AAZAAAA2AAAAZAAAEb EgbkEdbEAA AAAAah3h3kAA-AA AAAUAAAAAJAA  AAAA
A   AA2k2AA  kAAAEdb EbbgEAAEbEAAAAAAAAAAA AA ABA3AAAAAAAA  AAAA
AAZAAAAZAAAAZAAAEb Egb E bEAA AAABAAAAAAAA AA AgA  3 3ZgA3 bEAAA
AAf d       fAAAAE bdE b EAAA AAAgAAAA3 3  AA AUA AAA A A3  AAAA
AAAAAAG GAAAAAAAAAAE b EAAAAA1AAAZAAAA AAZAAAd    UGA3A3AA   AAA
AAAAAAEbEAAAAAAAAAAAAZAAAAAAA AAA 3 3 3Ug BAAUAAAAAAA A 3AAd  AA
AAAAgg|k|        |f    dfAAAA AAA3AAAAAAABAAAGAAgAAAA3Agb AA   A
AAAAAAAAAAAAAAAAAAAa b aAAAAEbEAA AAAAAAAAkAAAAAUAAAA U g3AAA  A
AAAAAAAKAAAAAAAAAAAahhhaAAAAA AgU3 3 3 3 3 3 3 3 3 3 3AAAAAKAA A
AAD  d pKAAAAAAAAAAAAAAAAAAAA AAAAAAAAAAAAAAAAAAAAAAAAA    pKA A
AAD AA  GAEAAAAAAEAAAAAAEAAAA AAAAAEAAAAAAAEAAAAAAEAAAA AA  AA A
AAD kA  Z b      b      b   |1|    b       b      b   Z Ak  |g A
AAD AA  GAEAA AAAEAAAAAAEAAAA-AAAAAEAAAAAAAEAAA AAEAAAA AA  AAAA
AADd   pJAAAA AAAAAAAAAAAAAAA AAAAAAAAAAAAAAAAA AAAAAAA    pJAAA
AAAAAAAJAAAAA AAAAAAAAAAAAA  f  AAAAAAAAAAAAAAA AAAAAAAAAAAJABAA
AAAkfkAAAkaAA AAAAAAAAAAAAk b b  AAAAAAAAAAAAAA AA a  a  aAAA-AA
AAAldfdfdddAA AAAAAAAAAAAA g d g AAAAAAAAAAAAAA AA 2  2  2    |B
AAAdfdfdfddAA AAAAAAAAAAAKp  g  pJAAAAAAAAAAAAA AA a  a  aAAA-AA
AAAddfdfdfdAA    AAAAAAAAAKp   pJAAAAAAAAAA     AA  hhhhhhAAA AA
AAAAAAAAAdAAAAAA AAAAAAAAAAKAAAJAAAAAAAAAAA AAAAAA AAAAAAAhhhkAA
AAAAAAAAAf       AAAAAAAAAAAAAAAAAAAAAAAAAA        gAAAAAAaaaaAA
AAAAAAAAAAAAAAAAAAAAAAAAAAAAAAAAAAAAAAAAAAAAAAAAAAAAAAAAAAAAAAAA
